XXXXXXXXXXXXXXXXXXXXX
XY M L  X           X
X XXXXXBX XXXXXXXXX X
X X   X X X       X X
X X X XNX X XXXXX X X
XF  X X   X     X   X
XXXXX XXXXXXXXX XXXXX
X     X       X     X
X XXXXX XXXXX XXXXX X
X       X           X
XXXXXXXXXXXXXXXXXXXXX
